13
11
230 210 80 255
144 238 144 255
WWWWWWWWWWWWW
WXPWPPWPPPWPW
WPPWPWPWWPWPW
WPWWWPTPWPWPW
WPPWPWWWPWPWW
WPPPPWPPPPPPW
WWWPWWWWWPPPW
WPWPPPTPPWPWW
WPWWWWWPWWPWW
WTPTPPPPPTPPW
WWWWWWWWWWWWW




