13
11
230 210 80 255
144 238 144 255
WWWWWWWWWWWWW
WXPWPPWPPPWPW
WPPWPWPWWPWPW
WPWWWPPPWPWPW
WPPWPWWWPWPWW
WPPPPWPPPPPPW
WWWPWWWWWPPP
WPWPPPPPPWPWW
WPWWWWWPWWPWW
WPPPPPPWPPPPW
WWWWWWWWWWWWW




